NO sprites/mossy.xpm

SO sprites/pillar.xpm

WE sprites/purplestone.xpm

EA sprites/wood.xpm

F 128,128,0
C 0,0,255

        1111111111111111111111111
        1000000000110000000000001
        1011000001110000000000001
        1001000000000000000000001
111111111011000001110000000000001
100000000011000001110111111111111
11110111111111011100000010001
11110111111111011101010010001
11000000110101011100000000001
10000000000000001100000010001
10000000000000N01101010010001
11000011110101011111011110001
11110011 1110101 101111010001
11111111 1111111 111111111111