NO sprites/mossy.xpm

SO sprites/pillar.xpm

WE sprites/purplestone.xpm

EA sprites/wood.xpm

F 128,128,0
C 0,0,255

111111111111111111111111111111111111
100000000110000000011000000001100001
100000000110000000011000000001100001
100000000110000000011000000001100001
100000000110000000011000000001100001
100000000110000000011000000001100001
100000000000000000000000000000000001
100000000110000000011000000001100001
100000000110000000011000000001100001
1000N0000110000000011000000001100001
100000000110000000011000000001100001
111111111111111111111111111111111111